000000000000000000000
033333333331111111110
011111111111111111110
011111111111111111110
011111111111111111110
011111111111111111110
011111111111111111110
011111111111111111110
011111111111111111110
011111111111111111000
011111111111111111010
011111111000001111010
011111111111101001110
011111111111100001010
011111111000100000010
011111114000001111110
011111111011111100010
011111111010000001010
011121111011111501110
000000000000000000000